3,3,3,3,3,3,3,3,3,3,3,3,3,3,3,3,7,6,3,3
3,3,3,7,6,3,3,3,3,3,3,3,3,3,3,3,4,5,3,3
3,3,3,4,5,3,3,3,3,3,3,3,3,3,3,3,3,3,3,3
3,3,3,3,3,3,3,3,3,7,6,3,3,3,3,3,3,3,3,3
3,3,3,3,3,3,3,3,3,4,5,3,3,3,3,3,3,3,3,3
3,3,3,3,3,3,3,3,3,3,3,3,3,3,3,3,3,3,3,3
9,9,9,9,9,9,9,9,9,9,9,9,9,9,9,9,9,9,9,9
1,1,1,1,1,1,1,1,1,1,1,1,1,1,1,1,1,1,1,1
1,1,1,1,1,1,1,1,1,1,1,1,1,1,1,1,1,1,1,1
